1111111111111
1C111111111C1
1100000000001
1P0011E100001
1111111111111