1111111111111111111111111111111111
1E0000000000000C00000C000000000001
1010010100100000101001000000010101
10100100101010100010010000M0010101
1P0000000C00CM000000000000000000C1
1111111111111111111111111111111111